WWWWWWWWWWWWWWWWWWWW
WFCCCWCCCCCCCCWCCCCW
WCWWCWCWWWWWWCWCWWCW
WCWCCCCCCCCCCCCCCWCW
WCWCWWCWW__WWCWWCWCW
WCCCCCCWGGGGWCCCCCCW
WCWCWWCWWWWWWCWWCWCW
WCWCCCCCCCCCCCCCCWCW
WCWWCWCWWWWWWCWCWWCW
WCCCCWCCCPCCCCWCCCFW
WWWWWWWWWWWWWWWWWWWW