WWWWWWWWWWWWWWWWWWWW
WF___W________W____W
W_WW_W_WWWWWW_W_WW_W
W_W______________W_W
W_W_WW_WW__WW_WW_W_W
W______WGGGGW______W
W_W_WW_WWWWWW_WW_W_W
W_WCCCCCCCCCCCCCCW_W
W_WW_W_WWWWWW_W_WW_W
W____W___P____W___FW
WWWWWWWWWWWWWWWWWWWW